8 8
250 250
1 1 1 1 1 1 1 1
1 1 1 1 0 0 0 0
1 1 1 1 1 1 0 1
0 0 0 0 0 0 0 1
0 0 0 0 0 0 0 0
1 0 0 0 0 0 0 0
1 0 0 0 1 0 0 1
1 0 0 0 1 0 0 1